TILEMAP
64 28 							-- Size of tile map in tiles
16 16							-- Tile size & block size
images/tiles.png 	-- Tilesheet
2 2 								-- Number of tiles in tilesheet
1111111111111111111111111111111111111111111111111111111111111111
11                                                            11
11                                                            11
11                                111111                      11
11                                111111                      11
11                                1111                  55555511
11                                11                    55555511
1111   11111   1   1   111111   1111                          11
11           1 1 1 1 1            111111111111111111111111111111
11                                111111111111111111111111111111
11                                111111111111111111111111111111
11                                111111111111111111111111111111
1111   1111   33   44   11111   11111111111111111111111111111111
11                                111111111111111111111111111111
11                                111111111111121111111111111111
11              111               111111111111121111111111111111
11                                111111111111121111111111111111
1111   111  22       22  1111   11111111111111131111111111111111
11            22   22             111111111111113111111111111111
11             22222              111111111111111411111111111111
11                                111111111111111141111111111111
11                                111111111111111111111111111111
1111   1111111111111111111111   11111111111111111111111111111111
11                                111111111111111111111111111111
11                                111111511111111141111111111111
11                                111111111111111111111111116611
11                                111111111111111111111111116611
1111111111111111111111111111111111111111111111111111111111111111

