TILEMAP
128 64							-- Size of tile map in tiles
16 16							-- Tile size & block size
images/tiles.png 	-- Tilesheet
2 2 								-- Number of tiles in tilesheet
77777777777777777777777777777777777777777777777777777777777777777777777777777777777777777777777777777777777777777777777777777777
7                                                                                                                              7
7                                                                                                                              7
7                                                                                                                              7
7                                                                                                                              7
7                                                                                                                              7
7                                                                                                                              7
7                                                                                                                              7
7                                                                                                                              7
7                                                                                                                              7
7                                                                                                                              7
7                                                                                                                              7
7                                                                                                                              7
7                                                                                                                              7
7                                                                                                                              7
7                                                                                                                              7
7                                                                                                                              7
7                                                                                                                              7
7                                                                                                                              7
7                                                                                                                              7
7                                                                                                                              7
7                                                                                                                              7
7                                                                                                                              7
7                                                                                                                              7
7                                                                                                                              7
7                                                                                                                              7
7                                                                                                                              7
7                                                                                                                              7
7                                                                                                                              7
7                                                                                                                              7
7                                                                                                                              7
7                                                                                                                              7
7                                                                                                                              7
7                                                                                                                              7
7                                                                                                                              7
7                                                                                                                              7
7                                                                                                                              7
7                                11                    5555551                                                                 7
7                                11                    5555551                                                                 7
7111   11111   1   1   111111   1111                         11                                                                7
71           1 1 1 1 1            11111111111111111111111111111                                                                7
71                                11111111111111111111111111111                                                                7
71                                11111111111111111111111111111                                                                7
71                                11111111111111111111111111111                                                                7
7111    111   333 444   111111111111111111111111111111111111111                                                                7
71                                11111111111111111111111111111                                                                7
71                                11111111111112111111111111111                                                                7
71              111               11111111111112111111111111111                                                                7
71                                11111111111112111111111111111                                                                7
7111   111  22       22  1111   1111111111111113111111111111111                                                                7
71            22   22             11111111111111311111111111111                                                                7
71             22222              11111111111111141111111111111                                                                7
71                                11111111111111114111111111111                                                                7
71                                11111111111111111111111111111                                                                7
7111   1111111111111111111111   1111111111111111111111111111111                                                                7
71                                11111111111111111111111111111                                                                7
71                                11111151111111114111111111111                                                                7
71                                11111111111111111111111111661                                                                7
71                                11111111111111111111111111661                                                                7
71111111111111111111111111111111111111111111111111111111111111111111111111111111111111111111111111111111111111111111111111111117
71111111111111111111111111111111111111111111111111131111121111111111111111111111111111111111111111111111111111111111111111111117
71                                11                          111111111111111111111111111111111111111111111111111111111111111117
71                                11                          111111111111111111111111111111111111111111111111111111111111111117
77777777777777777777777777777777777777777777777777777777777777777777777777777777777777777777777777777777777777777777777777777777

